35 28
##################################
#.......#####.......#............#
#######.#######.#####.####.#######
#######.#######.#####.####.#######
#######.#######.##########.#######
#######.#######.##########.#######
#######.#######.##########.#######
#######..........................#
#......................#.#########
#.############.#########.#########
#.#............#########.#########
#######.################.#########
#.............#..................#
#.............#..................#
#.............#..................#
#.............#..................#
#.............#..................#
###############################..#
#................................#
#................................#
#................................#
#................................#
#.........................########
#.........................#......#
#.........................#......#
########..#################......#
#@...............................#
##################################